player1 0 1
player2 1 1
enemy1 5 1
enemy1 7 5 
enemy3 8 8
enemy2 11 11
enemy2 10 10
END
IIIIIIIIIIIII
FFFFBFBFFFFFF
FIFIFIFIFIFIF
FFFFBFBFBFBFF
FIFIFIFIFIFIF
FFFFFFFFFFFFF
FIFIFIBIFIFIF
FFFFFBFFFFFFF
FIFIFIFIFIFIF
FFFFFBFFFFFFF
FIFIFIFIFIFIF
FFFFFBFFFFFFF
IIIIIIIIIIIII