player1 1 1
player2 11 1
player3 1 11
player4 5 5 
player5 11 11
END
IIIIIIIBIIIIIII
IFFFBVVBFFFFFFI
IFIFIBIFIFIFIFI
IFFFFBFBFBFBFFI
IFIFIFIFIFIFIFI
IFFFFFBFFFFFFFI
IFIFIFIBIBIFIFI
FFFFFFBMFFBFFFF
IFIFIFIGIBIFIFI
IFFFFFBVBFFFFFI
IFIFIFIVIFIFIFI
IFFFFFBVGBFFFFI
IIIIIIIFIIIIIII