player1 1 1
player2 1 10
enemy1 6 1
enemy1 7 5 
enemy3 8 8
enemy2 11 11
enemy2 10 10
END
IIIIIIIIIIIIIII
IFFFFBFBFFFFFFI
IFIFIFIFIFIFIFI
IFFFFBFBFBFBFFI
IFIFIFIFIFIFIFI
IFFFFFFFFFFFFFI
IFIFIFIBIFIFIFI
IFFFFFBFFFFFFFI
IFIFIFIFIFIFIFI
IFFFFFBFFFFFFFI
IFIFIFIFIFIFIFI
IFFFFFBFFFFFFFI
IIIIIIIIIIIIIII