player1 1 1
player2 11 1
player3 1 11
player4 5 5 
player5 11 11
enemy1 6 1
END
IIIIIIIFIIIIIII
IFFFFBFBFFFFFFI
IFIFIFIFIFIFIFI
IFFFFBFBFBFBFFI
IFIFIFIFIFIFIFI
IFFFFFBFFFFFFFI
IFIFIFIBIFIFIFI
FFFFFFBFFFFFFFF
IFIFIFIFIFIFIFI
IFFFFFBFFFFFFFI
IFIFIFIFIFIFIFI
IFFFFFBFFFFFFFI
IIIIIIIFIIIIIII