player1 0 1
player2 1 1
enemy1 5 1
enemy3 7 5 
enemy3 8 8
enemy2 11 11
enemy2 10 10
END
IIIIIIIIIIIII
FFFFFFFFFFFFF
FIFIFIFIFIFIF
FBBBBFBFBFBFF
FIFIFIFIFIFIF
FFFFFFFFFFFFF
FIFIFIBIFIFIF
FFFFFBFFBBBBB
FIFIFIFIFIFIF
FFBFFBFBBBBFF
FIFIFIFIFIFIF
FFFBBBFFFFFFF
IIIIIIIIIIIII