player1 1 5
player2 13 13
enemy1 6 1
enemy1 7 5 
enemy3 8 8
enemy2 11 11
enemy2 10 10
enemy3 9 11
END
IIIIIIIIIIIIIII
IFFFFFFFFFFFFFI
IFIFIFIFIFIFIFI
IFBBBBFBFBFBFFI
IFIFIFIFIFIFIFI
IFFFFFFFFFFFFFI
IFIFIFIBIFIFIFI
IFFFFFBFFBBBBBI
IFIFIFIFIFIFIFI
IFFBFFBFBBBBFFI
IFIFIFIFIFIFIFI
IFFFBBBFFFFFFFI
IIIIIIIIIIIIIII