player1 1 5
player2 1 11
player3 1 11
player4 5 5 
player5 11 11
END
IIIIIIIIIIIIIII
IFFFFFFFFFFFFFI
IFIFIFIFIFIBIFI
IFBBBBFBFBFVFFI
IFIFIFIFIFIBIFI
IFFFFFFFFFFFFMI
IFIFIFIBIGIFIFI
IFFFFFBFFBBBBBI
IFIFIFIFIFIFIMI
IFFBFFBFBBBBFFI
IFIFIFIFIFIFIFI
IFFFBBBFFVFFMFI
IIIIIIIIIIIIIII