player1 11 1
player2 1 11
player3 1 1
player4 5 5 
player5 11 6
END
IIIIIIIIIIIIIII
IFFFFFFFFFFFFFI
IFIFIFIFIFIBIFI
IFBBBBFBFBFVFFI
IFIFIFIFIFIBIFI
IFFFFFFFFFFFFMI
IFIFIFIBIGIFIFI
IFFFFFBFFBBBBBI
IFIFIFIFIMIFIFI
IFFBFFBFBBBBFFI
IFIFIFIFIFIFIFI
IFFFBBBFFVFFMBI
IIIIIIIIIIIIIII