player1 1 1
player2 12 11
player3 13 2
player4 1 11 
player5 7 8
END
IIIIIIIIIIIIIII
IFFFBIFFFFFFFBI
IFIBIFIMIMIVIFI
IBBBBBFBFBFBFFI
IFIFIFIVIFIFIFI
IFFFFFFIFVFIFFI
IFIFIFIBIFIFIFI
IFFGFFBFFBBBBBI
IFIFIVIFIVIFIVI
IFFIFGBFBBBBFFI
IBIFIFIFIFIFIFI
IFFFBIBFFFFFFBI
IIIIIIIIIIIIIII