player1 1 1
player2 12 12
enemy1 6 1
enemy3 8 5 
enemy3 9 8
enemy2 12 11
enemy2 1 10
END
IIIIIIIIIIIIIII
IFFFBIFFFFFFFFI
IFIBIFIFIFIFIFI
IBBBBBFBFBFBFFI
IFIFIFIFIFIFIFI
IFFFFFFIFFFIFFI
IFIFIFIBIFIFIFI
IFFFFFBFFBBBBBI
IFIFIFIFIFIFIFI
IFFIFFBFBBBBFFI
IFIFIFIFIFIFIFI
IFFFBIBFFFFFFFI
IIIIIIIIIIIIIII