player1 1 1
player2 12 12
player3 1 11
player4 5 5 
player5 11 11
END
IIIIIIIIIIIIIII
IFFFBIFFFFFFFFI
IFIBIFIMIMIVIFI
IBBBBBFBFBFBFFI
IFIFIFIVIFIFIFI
IFFFFFFIFVFIFFI
IFIFIFIBIFIFIFI
IFFFFFBFFBBBBBI
IFIFIVIFIVIFIVI
IGFIFGBFBBBBFFI
IFIFIFIFIFIFIFI
IFFFBIBFFFFFFFI
IIIIIIIIIIIIIII