player1 1 1
player2 13 11
END
IIIIIIIIIIIIIII
IFFFFFFFFFBVBFI
IFFFIFIFIFIBIFI
IFFFFFBBVVVFGFI
IFFFIBBBBBBBIFI
FFFFFFBBFFFFFFF
IBBBIFIFIFFFIFI
FFFFFFFFFFFFFFF
IBBBBBBBBBBBIFI
IFFFBBBBBBFFFFI
IFIFIFIFIFIFIFI
IFFFFFFFFFFFFFI
IIIIIIIIIIIIIII