player1 1 1
player2 11 11
player3 1 10
player4 7 6 
player5 9 1
END
IIIIIIIIIIIIIII
IFFFFFFFFFBVBFI
IFFFIFIFIBIBIFI
IFFFFFBBVVVFGFI
IFFFIBGBBBBBIFI
FFFFFFBBFFFFFFF
IBBBIFIFIFFFIFI
FFFFFFFFFFFFFFF
IBBBBBBBBBBBIBI
IFFFBBGBGBFFFFI
IFIFIFIFIFIFIFI
IFFFFFFFFFFFFFI
IIIIIIIIIIIIIII