player1 1 3
player2 13 3
END
IIIIIIFFFIIIIII
IIIIIIFFFIIIIII
IIIIIIFFFIIIIII
IFFFIIFFFIIFFFI
IFIFIIIFIIIFIFI
FFFFFFFFFFFFFFF
IFIFIFIFIFIFIFI
IBVBVBVBVBVBVBI
IFFFIFIFIFIFFFI
FFFFFFFFFFFFFFF
IFFFIFIFIFIFFFI
IFFFFFFFFFFFFFI
IIIIIIIFIIIIIII