player1 1 3
player2 13 3
player3 4 9
player4 7 3 
player5 9 9
END
IIIIIIFFFIIIIII
IIIIIIFFFIIIIII
IIIIIIFFFIIIIII
IFFFIIFFFIIFFFI
IFIFIIIFIIIFIFI
FFFFFFFFFFFFFFF
IFIFIFIFIFIFIFI
IBVBVBVBVBVBVBI
IFFFIFIFIFIFFFI
FFFFFBFBFFFFFFF
IFFFIFIBIFIFFFI
IFFFFFFFFFFFFFI
IIIIIIIFIIIIIII