player1 2 1
player2 11 2
player3 2 11
player4 5 5 
player5 11 11
END
IIIIIIIIIIIIIII
IIFFFFFBVBVBGII
IIIFIFIFIFIFIII
IIFFFFFFFFFFFII
IIIFIFIFIFIBFII
IIFFFFFFFBBMFII
FFFBIFIFIFIMBFF
IIBMFBBBFFFFVII
IIFBIBIVIFIFIII
IIFFFBFFFBFFBII
IIIFIFIBIFIBIII
IIFFFBBBFFFFFII
IIIIIIIIIIIIIII