player1 8 5
player2 5 11
player3 2 8
player4 2 1 
player5 11 11
END
IIIIIIIIIIIIIII
IIFFFFFBGBBBFII
IIFIFIFIFIFIVII
IIFIFFFFFFFFBII
IIFIFIFIBIIIMII
IIFFFFFFFFFFBII
IIIIFIFIFIFIVII
IIFFFFFFFFFFBII
IIFIFIFIFIFIBII
IIIBBGBFFFFFFII
IIFIBIFIFIFIFII
IIVFBFFFFIFFFII
IIIIIIIIIIIIIII