player1 1 1
player2 7 7
player3 1 7
player4 11 4 
player5 7 11
END
IIIIBFFFFBBIIII
IFFFBBFFFFFFFFI
IFIFIFIFIFIFIFI
IFFFFIBVBBFFIII
IFIFIFIFIFIFIFI
IFFFFFFFFFIFFFI
IFIFIFIFIFIFIFI
IFFFFFIFFFFFFII
IBIFIBIFIIIFIMI
IFFFBFBFBBGBFVI
IBIFIFIFIFIFIBI
IMBFFFFFBFVFBMI
IIIIBBBBFGFIIII